%%%%%%%%%%%%%%%%%%%%%%%%%%%%%%%
%.....%.......P.........%.....%
%.%%%.%.%%%.%%%%%%%.%%%.%.....%
%.%...%.%......%. ....%.%.....%
%...%%%.%.%%%%.%.%%%%...%%%...%
%%%.%.%.%.%......%..%.%...%.%%%
%...%.%%%.%.%%% %%%.% %%%.%...%
%.%%%.......%     %.......%%%.%
%...%.%%%%%.%%%%%%%.%.%%%.%...%
%%%.%...%.%....%....%.%...%.%%%
%...%%%.%.%%%%.%.%%%%.%.%%%...%
%.P.....%......%......%.....%.%
%.....%.%%%.%%%%%%%.%%%.%.%%%.%
%.....%.............%...%.....%
%%%%%%%%%%%%%%%%%%%%%%%%%%%%%%%
