%%%%%%%%%%%%%%%%%%%%%%%%%%%%%%%
%............%%%%%............%
%%%.%...%%%... .....%.%...%.%%%
%...%%%.%.%%%%.%.%%%%%%.%%%...%
%.%.....%......%....G.%.....%.%
%.%%%.%%%%%.%%%%%%%.%%%.%.%%%%%
%.....%........P....%...%.....%
%%%%%%%%%%%%%%%%%%%%%%%%%%%%%%%
