%%%%%%%%%%%%%%%%%%%%
%o   %   .    %    %
% %% % %%%%%% %% % %
% %              % %
% % %% %%  %% %% % %
%       G  G     % %
% % %% %%%%%% %% % %
% %              % %
% %% % %%%%%% % %% %
%    %   P    %    %
%%%%%%%%%%%%%%%%%%%%
