%%%%%%%%%%%
%G      oP%
%%%%%%%%%%%
