%%%%%%%%%%%%%%%%%%%%%
% G                 %
%                   %
%                   %
%                   %
%         P         %
%                   %
%        .          %
%                   %
%                   %
%%%%%%%%%%%%%%%%%%%%%